10
10
1111111111
1601111111
1010111111
1091011111
1010101111
1091010111
1010101011
1091919191
1000000071
1111111111