10
10
1111111111
1601111111
1011111111
1011111111
1011111111
1011111111
1011111111
1011111111
1000000071
1111111111