100
100
1111111111111111111111111111111111111111111111111111111111111111111111111111111111111111111111111111
1600000000000000000000000000000000000000000000000000000000000000000000000000000000000000000000000001
1000000000000000000000000000000000000000000000000000000000000000000000000000000000000000000000000001
1000000000000000000000000000000000000000000000000000000000000000000000000000000000000000000000000001
1000000000000000000000000000000000000000000000000000000000000000000000000000000000000000000000000001
1000000000000000000000000000000000000000000000000000000000000000000000000000000000000000000000000001
1000000000000000000000000000000000000000000000000000000000000000000000000000000000000000000000000001
1000000000000000000000000000000000000000000000000000000000000000000000000000000000000000000000000001
1000000000000000000000000000000000000000000000000000000000000000000000000000000000000000000000000001
1000000000000000000000000000000000000000000000000000000000000000000000000000000000000000000000000001
1000000000000000000000000000000000000000000000000000000000000000000000000000000000000000000000000001
1000000000000000000000000000000000000000000000000000000000000000000000000000000000000000000000000001
1000000000000000000000000000000000000000000000000000000000000000000000000000000000000000000000000001
1000000000000000000000000000000000000000000000000000000000000000000000000000000000000000000000000001
1000000000000000000000000000000000000000000000000000000000000000000000000000000000000000000000000001
1000000000000000000000000000000000000000000000000000000000000000000000000000000000000000000000000001
1000000000000000000000000000000000000000000000000000000000000000000000000000000000000000000000000001
1000000000000000000000000000000000000000000000000000000000000000000000000000000000000000000000000001
1000000000000000000000000000000000000000000000000000000000000000000000000000000000000000000000000001
1000000000000000000000000000000000000000000000000000000000000000000000000000000000000000000000000001
1000000000000000000000000900000000001980000010008900090900008000009809000090000800000000000000000001
1000000000000000000080100910000000000908000000080909008010010000900001010088109000000000000000000001
1000000000000000000000000000910000010000908988010900000000000090800001980000090000000000000000000001
1000000000000000000091081100000009800800000808000080000009010000010000010100000000000000000000000001
1000000000000000000009890900000000000080000000901000909800000099000090000010000000000000000000000001
1000000000000000000000080800001100900000801080080090190089800189991088890818001800000000000000000001
1000000000000000000000000089000000000009000098008890118000808000000000100980009000000000000000000001
1000000000000000000001101009000000010011001000000800800891908100100800800800091000000000000000000001
1000000000000000000000800100011010000000080100000008009080010189100090080008000000000000000000000001
1000000000000000000000090000099019001100800080809009100090000011009000118000010000000000000000000001
1000000000000000000008000089090000000011101010110080000019010800090901000000090000000000000000000001
1000000000000000000099088100000089900908081800000080908000800900800009100000001000000000000000000001
1000000000000000000000000801900001001000810100000191080000009000000009090008100000000000000000000001
1000000000000000000000000910000000090000000110100000090000000001000009900010099000000000000000000001
1000000000000000000000090000009000900800001998008090000000000000001000880000000000000000000000000001
1000000000000000000010099880008000000180000010000910000000000000008000980109108000000000000000000001
1000000000000000000000008800190000000000000019088010109000000000108980100890001000000000000000000001
1000000000000000000000800000000080810010110000090000000800800090000809001800108000000000000000000001
1000000000000000000000901110900009000890000009000808009088000010990010010009000000000000000000000001
1000000000000000000098101000000000890190119009800980000009000000000990000010990100000000000000000001
1000000000000000000019000900880000000800100000901000090008000000008000080190000000000000000000000001
1000000000000000000000181900800000900000081000000990090010009101090009090100001000000000000000000001
1000000000000000000009800090008000000001000900000100191000180000000000101018008000000000000000000001
1000000000000000000080000008000800108090900181001008000090090190009000800010911000000000000000000001
1000000000000000000080900000000089080000901000008090900100001000009000000000900000000000000000000001
1000000000000000000090000110889000100880000090010000000001000080000001008100080000000000000000000001
1000000000000000000001109010810100000800001009090000090880900000090909880009000000000000000000000001
1000000000000000000000900001090000900098000890010091000000900100081000888000001800000000000000000001
1000000000000000000009090091100019090098000900000990010000910110000000800008009000000000000000000001
1000000000000000000000090100900800100080900000009000000000008080100100090880010000000000000000000001
1000000000000000000090000009000008100191090990019010000908010010000000100180000900000000000000000001
1000000000000000000000901080990000100001809000119000000199809109900010000180881900000000000000000001
1000000000000000000010010908000800001010000080080081000000009009100080000081101800000000000000000001
1000000000000000000000000118001008900011911918081080090000900800990000880000098000000000000000000001
1000000000000000000008090001000100900008000000890800000188100180100010000990000000000000000000000001
1000000000000000000000100000008801099800908000000000090800090801010000010910100000000000000000000001
1000000000000000000000000080009080188080009000000100000000009108009010100000011000000000000000000001
1000000000000000000000000090008081090000001808000901000008180000809110808110108000000000000000000001
1000000000000000000000800000080808800000001009000988088018009090000000090809800800000000000000000001
1000000000000000000010190100001010990000000910080900010800001080000000100900101100000000000000000001
1000000000000000000080080000000900010801010090800801800100100000000000800008000100000000000000000001
1000000000000000000000010000001010000000810000901810000800180000008189000000090000000000000000000001
1000000000000000000000000908001000880000009000900100900199001000901090000000008000000000000000000001
1000000000000000000000189000000890000001001080909008008000880000109900000018018000000000000000000001
1000000000000000000009000080011000000000000900000100081001008000010080000110010000000000000000000001
1000000000000000000010901008011809000000080000000090801000000008090080080801000000000000000000000001
1000000000000000000000000000010808019000000000000818000000000010890000000090000000000000000000000001
1000000000000000000000008088000000080000080010000000008008800080010018000008180000000000000000000001
1000000000000000000090998910900808108001000000810010000080001000000000190000000000000000000000000001
1000000000000000000000010000000900900900810100908089000089000000000900090011008100000000000000000001
1000000000000000000010080099890198100000000000091900000000000990100018001001000000000000000000000001
1000000000000000000001000088000000000019000009900000000000101080100990090001810800000000000000000001
1000000000000000000000008890090801100990019101000000089101100900000001000900800000000000000000000001
1000000000000000000000009000000000101001088009001010000000000000010090009010000000000000000000000001
1000000000000000000010908009000000001091000990088800010001019000108900000000800100000000000000000001
1000000000000000000011100800010000001080000000100880001990008000908000010000909000000000000000000001
1000000000000000000000009091000099001001000000000091000010080800980900090800089000000000000000000001
1000000000000000000080800010000000009800000089000109800000010010000000909990010100000000000000000001
1000000000000000000009008000000008000800011900018080100001000000000000000090009800000000000000000001
1000000000000000000001090800090001110000800900890800080001000001090080900000100100000000000000000001
1000000000000000000000000000000000000000000000000000000000000000000000000000000000000000000000000001
1000000000000000000000000000000000000000000000000000000000000000000000000000000000000000000000000001
1000000000000000000000000000000000000000000000000000000000000000000000000000000000000000000000000001
1000000000000000000000000000000000000000000000000000000000000000000000000000000000000000000000000001
1000000000000000000000000000000000000000000000000000000000000000000000000000000000000000000000000001
1000000000000000000000000000000000000000000000000000000000000000000000000000000000000000000000000001
1000000000000000000000000000000000000000000000000000000000000000000000000000000000000000000000000001
1000000000000000000000000000000000000000000000000000000000000000000000000000000000000000000000000001
1000000000000000000000000000000000000000000000000000000000000000000000000000000000000000000000000001
1000000000000000000000000000000000000000000000000000000000000000000000000000000000000000000000000001
1000000000000000000000000000000000000000000000000000000000000000000000000000000000000000000000000001
1000000000000000000000000000000000000000000000000000000000000000000000000000000000000000000000000001
1000000000000000000000000000000000000000000000000000000000000000000000000000000000000000000000000001
1000000000000000000000000000000000000000000000000000000000000000000000000000000000000000000000000001
1000000000000000000000000000000000000000000000000000000000000000000000000000000000000000000000000001
1000000000000000000000000000000000000000000000000000000000000000000000000000000000000000000000000001
1000000000000000000000000000000000000000000000000000000000000000000000000000000000000000000000000001
1000000000000000000000000000000000000000000000000000000000000000000000000000000000000000000000000001
1000000000000000000000000000000000000000000000000000000000000000000000000000000000000000000000000071
1111111111111111111111111111111111111111111111111111111111111111111111111111111111111111111111111111