100
100
1111111111111111111111111111111111111111111111111111111111111111111111111111111111111111111111111111
1600000000000000000000000000000000000000000000000000000000000000000000000000000000000000000000000001
1000000000000000000000000000000000000000000000000000000000000000000000000000000000000000000000000001
1000000000000000000000000000000000000000000000000000000000000000000000000000000000000000000000000001
1000000000000000000000000000000000000000000000000000000000000000000000000000000000000000000000000001
1000180000181010181010001011991101091110080810880198000880000000019001900001808080800010001000000001
1000111009000810809990188001891081000008001800001098801008900018100000000909010100091000010011000001
1000019000001109900098000180091000010010981900119000110181010801100980080080109800001009100010000001
1000109001110910800000080001910189080101900180001100009010010001000008000891111081911080000100100001
1000089000080188000100001000100000009009000001011001001000010100090001001009890900881011010110100001
1000008800809010101900110811900000910901010010089009010000089000008010100800809900801001001098110001
1000091010000080010800000090000000908091900011090119000100910800008101000091900010010001000000110001
1000001008180010180010000009080000888010019000000001009000080001900081810800001000900000010800900001
1000010800199000000800001008010910090081008119000010801910000008109110011000010000000008010100090001
1000110089108000001000090100090110000000119809801009001101189100810981010000181000809018101810090001
1000080009100000000018800118008001101000010100001009081019019808008090800010111980800080918000900001
1000810000000180000180001909081101190110800008010080089101009000000008009000100010110000911090000001
1000010190008109001010800019000890080080100101001189900090900000010000081001991000190990000000000001
1000110800899001019010819008101091090890110809010000900080000000000000000800008891000890000080090001
1000900001181000000910091091001000090910011880910900089101010000808000900011080101800108800180010001
1000009090000010011191100000880000180009991110011180001010080000001808089098100000100010001810900001
1000000000110091809001919190908091190010010010000800010009811080000080010008000081100900001091000001
1000000009008911080000080990801900801119100000001009101009009110101019009018081008018000110080090001
1000101001010980000091000900910080191101080000118181199809001001181010009100001090008108901011100001
1000000001118909000110111010818919800008000000111188119000010000010918090181000098809001810180110001
1000918081019000909800180909090000088900800108009001090080000981010009001011110189000000000900000001
1000900001001010100089080100000000000800000101880090900108800901010011000001008009080109000908080001
1000001100010100019000000001011180010100090100000901000989110000001000901000099010109000008119000001
1000008100001080101000000809900810009000000010010800800001000008000901190000109100011898100119000001
1000080000990098110811101109001901001911801000811000899000100000180011810900001000010018090000080001
1000018018010000089100010081890010090100910000081000090919119998009800000900010191001001809080090001
1000019001988808800000900800000000801081000180010090099001080980110000000180010000100111098000100001
1000810800000810811100000191101019000009000181000818800008900110099081190018098109808000000111900001
1000191010900800091198000100001000000101110110000091091800001001000081080010091081190089001010910001
1000890000910000010001000000808000011890100000090001110000000119800088101001899001000101008090080001
1000011109000081001100009009000000909000109100009010009018000000000001190019080100100000000011900001
1000091108081000010001091100009809090001011000009108009081980190000000000000100009008081008110100001
1000909901100090000000100900000008001000900900000090008008000000108001180000088000000001111190010001
1000009100090101801880100000110000001001010111081101800090000080000100000100100011000000000100090001
1000098800010000010900088000000090080800000810988010980000000000098100080000110000080001091000800001
1000090008100000000109100990000000010010090109118000010991001009010000190010908000010900009100000001
1000100009080000009909908001000010001000119010080008001110080188018009800081000801000098819100100001
1000001810010010181099011000090009101000001800800801000808001019000000000910001901000088001010900001
1000000000000000009000001000009110000108100080109009808000809010899098111110900001000010800101080001
1000910010181809800891010000110090119100000010000000881001810090100010010000198100001000009009100001
1000800809889010000800110001000000000008800110008000100909000011980100000019909100080008000001190001
1000001100010800011100010090090000011108000000001009000900010009019000010011911888001000980011110001
1000100008001019080008090000000800000089000000080109101000000001000000000100000010100010001010000001
1000000001001911011800091000890010100100018101001110000000101011001000900900101100900001000800800001
1000000011011091000800009090111110900800000890800000800800010110010010000010000000001000001918000001
1000008018010000008000101018908908800000010100000080890908901000008000000180011008019100100810100001
1000000008108001010000100089180000110000089000000901011010009900109010808010018000180001000800100001
1000900000099081000080101000809800000109901900901080000089199000001009010000081011018008180008000001
1000808881800019000000100010001908008800000100100099000101080008000000900000980000000000810101900001
1000080001800081109100119100180900800911098001191001909110800019090180001101100080109001090808010001
1000080108010110080110010000008001800910100100109800100001908080000001119000001000080101190981190001
1000089000080109081909018010001001990809011018000000809108089001080080000981008000099000910001000001
1000080009108000000009109001000090000080000109080011001100101000918118110100180080000010118808010001
1000909010000019100801090119910998091000800180080108000099010080000190010991000000000000190011010001
1000100100009810100900090010000100901900000090011001000010010019000000010019100910010011000901110001
1000000108101908000080010000900009008080199008190009010801800001010080000110009108189010801011000001
1000118109890000001008100000000901800009011090109001080901100000010090010001891010000000000098800001
1000800010810000000810001901918000001009001100000100890000191080108018001800009100000000900008110001
1000010000100000809810101110080100001000080090810000901010181108010900000019009001900001080100100001
1000100910009010000100000000108099008009990010080901000080010100000908809100018111111981180010000001
1000010910100809000101891001000911080100800900908000801000010080011180000000001000000080101000010001
1000010000001019000099010800800001091018001000119000010099010089000090009910018001100088090008000001
1000810000100090118080081910000100108800010101099091010800001800801010010001900010800180900900810001
1000901010000001800190801018000109900109180000900098101191019000100010119080000819109801191190000001
1000088001090919001810101010010010980090800000010008108901001000000010009180111080080089001090010001
1000910109099810898010199000800191810088901990011001010008010000090000000198000809900000108000080001
1000091901119000100809019018000100090010000188009100100010809000101900919919100890180011100010090001
1000800091018188090001000000800000810800010000090010080000000000019000000199000081100000910880000001
1000100190190018011908101010000100000810001908011001000088000001110100980801000009009000000811810001
1000100000800000809000008080100800010899009800108980010001080118910009001908000000008100800009100001
1000008909000900010101101080800001101180801100090011009900090090018091088008810000000080000800000001
1000810808100880090910080101000011100909080091109009189018100011000100100000900008910000001000110001
1000900000080890911000100099800011000111090890000001019000809900000180000990000010000000000011000001
1000000000098919818089800801001010000098090001900109000008000811019090080901808019801000009008000001
1000109080010001000090100100180000100090100011080080090910000090000001090100080800011001010100000001
1000010101800901100010000000000000901080001189090000000100001000080000099000118000191098901118010001
1000001111001100011000099888100000009011900019001010108000900980000900900000018000080000000000810001
1000910080990108000108101001100090008901000110900190100081909001010009101001110090090119809000090001
1000001900001081098898000908001018890009081000000080000011010010000080080100109081010000080000000001
1000019900000011099008008080000009019011001900000998100000000000100011908001811000000880000000000001
1000008110801108900001000000081019100000001108100100108000000100009101809010010000010901800010090001
1000000000090080000000100810010000001889100001000901800900000110010008981019100081900000080810100001
1000899000000000088800001101010000809910089100000080890001011000010100800000011990808100010091090001
1000081008010188000090000101000001001000108009000008009110010808010188009911180900910008918001800001
1000010111000008110100000001018000001000110801890000108010009998010000008000010008010090100081010001
1000001800000190110801000109100010900900080009000000800190000010190009000090800001000800019010890001
1000000108109118000100800100000000090880000100010089801010080108000800110800010800800000800810010001
1000090900091800080000010010080000001081100189901001801080090001000000009011800000118000100890990001
1000011198080000019010800000880809808000100000000011900100190010819081000110080011008081091019000001
1000011000081000001100000109080000010090081810000808800100801081090018000800000800100080080181100001
1000111000010009011189000091010101000001010900000009981000080101890009000000010010100000019000010001
1000000000111090098000000000000190000091009800110189010090800889000900091890009100119000000100000001
1000000000000000000000000000000000000000000000000000000000000000000000000000000000000000000000000001
1000000000000000000000000000000000000000000000000000000000000000000000000000000000000000000000000071
1111111111111111111111111111111111111111111111111111111111111111111111111111111111111111111111111111