100
100
1111111111111111111111111111111111111111111111111111111111111111111111111111111111111111111111111111
1600091100000009100009000000000001010010001090000100001000000000000009000109000000000101090000010001
1000000090000090000000000000099000000010000000010000000000001000000999001190909000000000090000000001
1000000000000090000000000019000110000100000900000100000000000000000000000000001100109101010000090091
1100000100009090019010009000100001000000000000001090100000000000000001009010909909001100000001100001
1001000000010900000000000000000000011100000000090000000000090000000000010090090000190990000000000101
1100000000000000000000000001000001000000090000090000000090100000090010000000100090000009000010010001
1000000100000000900001000009000000001090009009000100000000000009099000990000000000000001000000000001
1001090000000000019001001000100099900000010910000099991009000000000091001000009090901000000000000091
1900000110990900100100901100000100000000090000010000090900099000000900011000109009909009000100910101
1900000000000000000910000100000900009000000000000000000000000000000000000900000010000009000000010901
1100000000019000000000000010011110100010000000010000001100009990009001000900000900000000010000100001
1001109000000001000000100010000900000010000010000000000100000000000000000000100000000000101909900011
1100009009000001100000000009000090900000000019010190010009000000000900000000000000909901900009000001
1000001910000010000000000000000000000000000000009100001090000000090000000910090090010100919100900001
1000100000900900001000001000090000001019000009000100000000000000000000109000110000100000001000100001
1900000000000000000001011110001110000000000010010000090000000000009900000000000000000000000000000001
1090000100009000000090000009900000010009009000900000000090099110000010000000000190100000000000000001
1000010000000000000010000000010100091100000000000001009100000001900099000190000109090000900000100001
1000000000001000000000000000090000900000091001000100001100001099010009000000000000000100000100009091
1000099900910000900000099000009000000000000000000900010091090000009900009000000009000000000900099001
1000000000000000000000090000000010000009000001090000001000000000010910099900901000000000100000000001
1909910000009000009900000000000009000900090009000000010901000000090000000100900000000000010000000001
1100090000900000000000001010000010000009100000000000100000000000000000000000900090000000000000000001
1000011009000900000000019109900900009900090010000900000000900000109000000000090090090010000090000001
1910010000000000000010019000000000010900000000000000000001100000000000000011000090000100001000909091
1000110000000000000000990000000100001000000009000000001909000000100900091000100099900000190009000001
1000000000000000090000000100000090090001000000091100009000000000000000009009100000109000190000100001
1099001090010000000000001109000000000090100110000090001000000000101919000090010000000000900100000001
1100099000000090090090000000010091000909000009000000000000900000000009101099001000090000990001000191
1009000190000100000000000101000009090900010000000000001900000009000000000090000000100000090000000101
1000001000000099000000100000090100000009001000001100090101000910000009000090000090000090990091000101
1009000000000090000090001000999000000000900000000000000091090900000090000001000100000009000000100001
1909900010000000001000001000000000990000010900001000090001900000000100090091900101900000900101000001
1901000000000010990000010000000090000000110000099000001000000000000900000000090110100001000100000001
1001010000091010000900900090000000001000910000000090001000900000009000900900009099000000000100000101
1001000090000110900101009010000000900900009000000000090009009090000000090190109900090009009009000001
1001001090900001000000900001000000001000009019001090090109901901000010001000100010000900110000000001
1000019000090000000090000010000000000000000000000001000010000000000100000000001000000000000009100001
1090000000000000900000100000000009010000000000000900000000001000000900901110000100000000000000100011
1090000000100000009000100010900009100090900000000101000000010009000009100101000000000000911090001101
1100009101900900090090000001000000000090000000009000000009900000000091000000000090000090009000000011
1000000000000000000001000000090000109900901101991001100009000100000000090900000000011100000019000001
1000909000000900010000900900001190109019000909090900900000000900090001900000000900009011010000001001
1000000001000000000900909000000000090000100990000000009000009000010000000110001010090000001010009001
1090001100000001000000000909000000000100000001000000000010000009000900000000900009010000090900900001
1001090090000000010000000000000990900000000000090019900000900900000000101000000910000009000000901091
1010010901000000010000900000900100000000001000900090000000000000001900000000109010019910010100000001
1090900000000000000000910000099900000000900000001000009019910900000000101099000099010010000000900001
1000000900000000000000009100000990900090090000900000000000900900000900000900000090010000000119100091
1090900090000009099010000000000900000000100000001000010900090009000910000190000000000090001000010001
1090001090000009000009000001010900100091010000000000900109000000009190090010000000900009000000090001
1000000000000000000000000000000000900900099000090000000900000100009000000000000000900900001011000001
1900000011000900109000000000000900000000000000000190000099009900001000010900000000009000090100000001
1091010009090000100000000000010010000091000109000000000000100000000000010009909001009000090000000091
1199001009000010000000000000000000000900000000000009000099100000010000001090001000910090000900100001
1100000000000090100900009900000000000000000000910001100009011009010019000910000000000000000090000991
1000000000000000000000100001909000090010100010010009900000900000100000000000900000000000000010000001
1900110100100000000011000000099000009000100000009000000000000000000000000009090000000009000009900011
1000010000111009000000001190100001001001000000000000000010000000000000000000000010100010000101001011
1000000000000000000900009000000000000000000010001000000901909101000010000100000000000000010001000001
1900090000000901000000000000109000901090900000000010000000091000000000900001090100900090010009009901
1900010109190900019000000100900090000000010000000100000000090000900000190000000101000900000000010101
1900000000000000000010000909000000101010090001000010090090001100000000000901100001000001000099000001
1009090000000100100001900000000001000000900000090009000099000001100900909001000000000000000090900001
1000000000000000000000000000009000100090000000000000009110910100000090000000000009000109000000990091
1090000910090000000000009000900000010100000000001900000001000190909000901000000000000900100900000001
1000000000000000190000910000000100100090000000900000090001000090009100900000090009000001100000000901
1000000000000010000090900909000000000000000000900009010090010009000009000009000000000100000990009001
1000900090100000100900000000000909000090000000110090009000000000000001000000000009000000000000001001
1000090000000900000000010000001000010000100000001000100000000000100000001000000000009900110000900001
1000000090101090001000009100000000001000000000001000990001101000090090000001000091990000000900000001
1000090000001000000100000000000001090000000009010100010900000000000909009009100009000010100000090001
1100100090000000000090000919900009000900900019000000900000000000001000000000000090900000010001000001
1010900000000010000000000900099001100000001000000099000110100909100011000000001090001000091100009091
1900009000000000000000009000009000000000009000000000000000010100000000901000010000010010000000000091
1010000010001000000900000001090000009000000009900001100010000000000000000000000000010919000100000901
1000000900000000090900000011900001000900100900000090000000000000000000100009000090090001100990900091
1000990000000000000911010010100000000000000900000000000000910009000000009100000000100000010000909001
1000001900000000000110001000010109000000110000000000001091100009009001090100001000000000090000010001
1090900001909000100910090100119091000090000000000901000090000000900000000090000000000000000900001011
1000000000100000100000090100009000090000001000900000000001009019000000000900000000000001000090000011
1000900100009091000000000900001100000000190100000000990000010009001900010090000110000101100109000001
1900111001000000000000000000019000000900100009000090000900000000900000000000000100010090091000000011
1090000000000000000010090000000000901090009000000000000000000990000010000000000000090000109000011001
1000910000900001090090000100100009000010000000000000090000119000090900000000109901001110010100100001
1011009000000090009000010900000000000900000000110900100000000000900090000000000000000000009100000001
1090001000000000900990000090090009000910010000000000000000000191000000000009000000090900000000010001
1000000000000000900001100010000000000009000009090001009000000091090000090000011000900900000000009901
1001091100000000010001000000000101900000010000090100001000001100099000000010100000000009000000000001
1000009001000000990000010010100019000190000000000099000000000990999000090000001100000000099000000001
1000010000009000010000000090900000000100000000910000000000000900019010900000000100090101000000000101
1000000090010090100009090090000090900001000000000000000000000001010000010000000000000000000010000001
1001000000000100000009900000000000009009000000010001001009109000009001000000090109010910900000000091
1000900000090000000000000001000109001010900990090000900000099000000000000900001100010000000190000001
1009000091099001000000091901100090000009900000900000090900109000000190090000000000000001000900000901
1000090901000000000000000000000000000000000000000001000009190000010000000100099000000900000009990101
1900000100090009011000000910900900009000090000000000000000000000000010000010000010900010000000009111
1000000091000000009000009000000000990000000000000009000000000009000001000019000010000000010000000171
1111111111111111111111111111111111111111111111111111111111111111111111111111111111111111111111111111
