100
100
1111111111111111111111111111111111111111111111111111111111111111111111111111111111111111111111111111
1618090190001800980809800000800100000108000000000000001109000180910009000000001990101000811900000801
1000010000110801180099900908000110010810909019190080110000100189190800000100801901101010000100000001
1090010901880090011001180101189001800000101900018090908010810900008000000008080000189000000010000001
1009010090101018088100900100001000190088000100099810980800080009001108009900080000101901800000000801
1001000090011089099890009101801910109000188000191110001000001108101000008000801900000000011800010901
1011910900019090108009080900008191100080000000800000000008908000000010090190811080000000000000008011
1890901090100800080100191091000900100980000180000098900000080081008180010000001001000081000109100001
1000000010088001001009000010000009091098110009100909019900088008000909019010000000109091110808108901
1001000190000100000108088100008100000100091090018000000980100100191080800081998009080000000080001101
1000800108911090810981000000000000090091810000000080000090999100009100081000910000000011101880090011
1000011800801000190800090900000000908001008000100080090800100000090901001011099010000100000109009011
1089080010098901908080001000008001108810100000009000190000109009000801111100008000000010081000808001
1010000000100081800000080000001800000000080000011010901001000080010090880001090090191108900181008011
1100009881080008091010088010001000100900900001000000088800009000108010880000901000909019010900000911
1801810800011000880001018900001001900000018019009088119008900008091090100108880081100091098010008001
1100000810001000090100010900001900180100800100189000101100100890000081918000109011080088000009100001
1000080800910099100800000800008990101000010111108080000100018190001910800088190000080001101080000001
1001800010000101800810000000090900010088190080190000700001080100800900800010100010009810809000810001
1000990011109018019190008001180000808000119109110000088198080901119101899098000118110800100981000801
1000991190801008000109090108000001080000088000008000009010110000001800000101000100100100010111010001
1000001091009001000000000110981009100800001190109908000100000100008000890000000800800190000001000101
1991001090008990010009110901010000000000001081010100000000191001000001000818001990010010001980000001
1100000900010019100001100180800010000090100100909010000000008100100000101100880001001091008091098801
1000100101001100119990000000090100100981900001008100000081000000911011909101090110019101100800111901
1190000001010010810190011001000991089100800018010010000010908000000000000001100190800019018019800001
1100000008008000800011100800080911090018118098101100000080018890080800001099000911180000109800011801
1090100819808000090109000000080000901009000109999080900100000001900000910890989000010010090111100991
1908810000011100100000008001888000100101010110009000000080089090080009800001111980100010000111080101
1101019901100088010801000109019009008010100090010000000109180101000001000011001010008090980088801911
1100000900800000000810890110000801008009190190000108009000800800090100011080000010000080000008008011
1890001000001008901011000080101000000801008000188100000101800011080000000000080100000000190911819901
1990091100191108010010110008988101111100898009010000089180101000001190109000008000000009000880800101
1000080100911081900018010108101008000008101908809000000800000001001000900898101100080900080000000901
1000100980000800001009001009000810080108101000000900008811000010000081000081000098009100000089000001
1009000008900000000000000011800180009908008110018001000118100000090091010100900011009009811010801081
1909010981080000000081918008000901180009000011910090001090000000100011010990000000000909100900180111
1110000089008000889100111101010909011900019001000001800100919099080009008001000080810000009010001911
1888111008098108010000000819100000091008010000080098800111000919001090109909001091010080000118800001
1899008000100000810901009010110010800080000100009110080010010080088109009000900900001100000010900001
1080890090900010018001000100000800100008808001010098011099901089189009010008801090880900801101800011
1100810009800111000000998000100800900080190000980000889001911090080100010100000910100901000000890011
1000810808090000800818090180100000000008080000010090808010909000010009080000801011000000800008080001
1008010100010991109000119000980100011819100090081000900900000100880100888900100001180001988001110011
1088008000000000180199090100908080100901010819009190901190080008091000000900000900080800010080010891
1000100000188808100000000088000000010010000099010000000100009090081908000000100011009009000900009801
1110000800100181800001010091010011010000000900001910009809108190001101000008111901000119011109081991
1000080008919090909000900108001800000100810000109091110100880011008108011081000010808000890000000081
1008900900009819000900018000198081100010091000090081000110009100118009010010901090110011100110001801
1011000110800001180100000000000811011010009810089000980010801111091080000001000080000009108001800001
1000890081000018801199000009001100101010018009180801810909098000000198000110000800100080190000000001
1800911000001011010818010980000000110080888001090000000110000009001100900000000009000090101800000001
1010011191000180000009080110008180910001100180090000090081011009100100080111009008801000090900090001
1090000018101000900100000000800090090900901010100000000010181810080800801110008008909090108001100011
1000000001010000800000000098090000000090001001181008900191000000000801080000901001100800000000991801
1008910108900901001019100899001100100090100800000800000009000808901010090081909800080001000001000981
1800001090100111100800001009110991100081018000100010880100010191809080010888000099010088000000900001
1100001081080190000081100800119800900000000000010080100001101800010001090108009080080009100090000001
1108010001000009091800190908900100090811090101010011001009008109008100001000001001800889000011001901
1110100000118000091088010010900910000080101019109808110100000900800110018810000010008909000000000801
1108109001000000001100089000010010099918100100000090080100000010990000000110000110100010011011890001
1911000010000100980000081000800000000000190800008000000111001108089891190000001001119000000081900011
1010900010091010000001001019810000190080090009091001000000000090910001001099010000900000000910100991
1080008011018000009800900911000190098101000009008080180000100091010009081801010811810100900009001111
1018180911101080801908008088818900800000110800910000100180000808000001001180101190110081819008000101
1000011001808000000000000981001091800901000900180909801000000009080000881800100009000100810000001101
1080990010800090118080118111100019000000910010100100000000090010001010890000018000001008000009010101
1010001890008001010100001000911010001100100001000000008008801001980000009081001001088000009008880001
1000000000000091000091008011000000010010810000100000100901010810800008000000010101100000001890008911
1000010000010018000190900008091100901098110000190010080100019009001001000000110001100000880001891901
1011010080100009090001101000100111000000010080009000010001800000019100900808011000901098000108019911
1000000008009108009011090000000900800011010000001101910101008010000000001800009101000000010900001001
1000098090890081100800091009090090010080109910080081188000181090000108890100800001010000000009000811
1010018008000000000080000010900000000000008188008901190009000080000000991000010080000108100080010001
1181100080801001008011900090180008109009801019010000000010001001000000198901000000000080100000000081
1810018000080000100810819001100100180010800089800910911009019189009001098888001010110001000919000111
1900880000001000100100000800110090001110108080000019000000001100118819880801111110000818100000110011
1811108010008000000900000080018110001000000110011010081188100180000089009190800810001081100001100101
1900908000000010810900810010000110800108000010011091890009000819000008881101800009000111090001191091
1080081001910000010010001010010100101090011809008010000019000810890011018109000180000000010010000811
1000100080101110100001001101019010010900000011000100001988000000000001011001000080089001880000100101
1080900800000110009981109000008900000000000018009011100088101001018008800001188810011000000190009001
1008011800000119191008000001900001099809801101011818000000000001981080980101900910010800100100019001
1910001119011091000100000001019800810001800009001110900009010800008900008099180801080000018110109811
1000100180100110901090091180000800090001001900000100080990000110800910009089000801000080090000091011
1101001001000008990008080000900080010110010100000001890000000090000900010190109001181000010000908801
1001810090000089009011988099800089011809808101098001009010901000008101000019181018090009001100101801
1091018111000090090891001000900000009010901001080108110100000000098000198810190908000000000001808101
1001001180108801009090001801100180009081101019009090000101101088100008110999000080000880000000000001
1001111000009901000008001000011001010808000080800901098180008180008800191000800101980100010081908001
1080008810110000001000800001180100000190911080010800019000801100019810009100908000800011001198090001
1091019000080801018090090000110010011118000018888100001110000000811011000011100081008000101081901001
1008800000001100010000000000000880108810011980908089190800111101009080100100000001090010000019880191
1010111011100119080010180018100190001011019080988009800008018909000010900100009111100000001010080101
1101088008811908011101010000000000910800008090801000091000099001098000001000100190000000800000010001
1818900080088080890000000000101890109080011000901008010009001900001099100001101100990000009000990011
1000800080198009000010099900189090018019091000001100189010181000800990000000010800080901190899008011
1010000000001888811000009001001010089001000101090010000001000000009080009008909189019911010090100011
1000001880000080808000001000100108000008100000100801000900100080991809108000000000800101100900910111
1111111111111111111111111111111111111111111111111111111111111111111111111111111111111111111111111111