100
100
1111111111111111111111111111111111111111111111111111111111111111111111111111111111111111111111111111
1601199999999999999999999999999999999991111111111111111111111111111111111111111111111111111111111101
1110111111111111111111111111111111111111111111111111111111111111111111111111111111111111111111110001
1110111111111111111111111111111111111111111111111111111111111111111111111111111111000111111111111111
1111011111111111999999999999999999999999999999999900000000000111111111111111111111111111111111111111
1111101111111111111111111111111111111111111111111111111111111111111111111111111111111111111111111111
1111110111111111111111111111111111111111111111111111111111111111111111100000000000000111111111111111
1111111011111111111111111111111111111111111111111111111111111111111111111111111111111111111111111111
1111111000000111111111111111111111100000000000011111111111111111111111111111111111111111111111111111
1111111100000001111111111111111111111111111111111111111111111111111111111111111111111111111111111111
1111111111100000111111111111111111111111111111111111111111111111111111111111111111111111111111111111
1111111111111110111111111111111111111111111111111111111111111111111111111111111111111111111111111111
1111111111111111011111111111111111111111111111111111000000000000111111111111111111111111111111111111
1111111111111111101111111111111111111111111111111111111111111111111111111111111111111111111111111111
1111111111111000000100101010101010101011111111111111111111111111111111111111111111111111111111111111
1111111111111111111011111111111111111111111111111111111111111111111111111111111111111111111111111111
1111111111111111111101111111111111111111111111111111111111111111111111111111111111111111111111111111
1111111111111111111110111111111111111111010101000001111111111111000000011111111111111111111111111111
1111111111111111111111011111111111111111111111111111111111111111111111111111111111111111111111111111
1111111111111111111111101111111111111111111111111111111111111111111111111111111111111111111111111111
1111111111111111111111110000010101010010101011111111111111111111111111111111111111111111111111111111
1111111111111111111111111110111111111111111111111111111111111111111111111111111111111111111111111111
1111111111111111111111111101111111111111111111111111111111111111111111111111111111111111111111111111
1111111111111111111111111011111111111111111111111111111111111111111111111111111111111111111111111111
1111111111111111111111110111111111111111111111111111111111111111111111111111111111111111111111111111
1111111111111111111111100000001111111111111111111111111111111111111111111111111111111111111111111111
1111111111111100000000001111111111111111111111111111111111111111111111111111111111111111111111111111
1111111111111011111111111111111111111111111111111111111111111111111111111111111111111111111111111111
1111111111111011111111111111111111111111111111111111111111111111111111111111111111111111111111111111
1111111111111011111111111111111111111111111111111111111111111111111111111111111111111111111111111111
1111111111111011111111111111111111111111111111111111111111111111111111111111111111111111111111111111
1111111111111011111111111111111111111111111111111111111111111111111111111111111111111111111111111111
1111111111111011111111111111111111111111111111111111111111111111111111111111111111111111111111111111
1111111111111011111111111111111111111111111111111111111111111111111111111111111111111111111111111111
1111111111111011111111111111111111111111111111111111111111111111111111111111111111111111111111111111
1111111111111011111111111111111111111111111111111111111111111111111111111111111111111111111111111111
1111111111111011111111111111111111111111111111111111111111111111111111111111111111111111111111111111
1111111111111011111111111111111111111111111111111111111111111111111111111111111111111111111111111111
1111111111111011111111111111111111111111111111111111111111111111111111111111111111111111111111119111
1111111111110111111111111111111111111111111111111111111111111111111111111111111111111111111111111111
1111111111111011111111111111111111111111111119111111111111111111111111111111111111111111111111111111
1111111111111011111111111111111111111111111111111111111111111111111111111111111111111111111111111111
1111111111111011111111111111111111111111111111111111111111111111111111111111111111111111111111111111
1111111111111011111111111111111111111111111111111111111111111111111111111111111111111111111111111111
1111111111111101111111111111111111111111111111111111111111111111111111111111111111111111111111111111
1111111111111101111111111111111111111111111111111111111111111111111111111111111111111111111111111111
1111111111111101111111111111111111111111111111111111111111111111111111111111111111111111111111111111
1111111111111101111111111111111111111111111111111111111111111111111111111111111111111111111111111111
1111111111111101111111111111111111111111111111111111111111111111111111111111111111111111111111111111
1111111111111101111111111111111111111111111111111111111111111111111111111111111111111111111111111111
1111111111111101111111111111111111111111111111111111111111111111111111111111111111111111111111111111
1111111111111101111111111111111111111111111111111111111111111111111111111111111111111111111111111111
1111111111111101111111111111111111111111111111111111111111111111111111111111111111111111111111111111
1111111111111101111111111111111111111111111111111111111111111111111111111111111111111111111111111111
1111111111111101111111111111111111111111111111111111111111111111111111111111111111111111111111111111
1111111111111101111111111111111111111111111111111111111111111111111111111111111111111111111111111111
1111111111111101111111111111111111111111111111111111111111111111111111111111111111111111111111111111
1111111111111101111111111111111111111111111111111111111111111111111111111111111111111111111111111111
1111111000000000000000000000000000000000000000000000000000000000000000111111111111111111111111111111
1111111111111110111111111111111111111111111111111111119111111111111111111111111111111111111111111111
1111111111111110111111111111111111111111111111111111119111111111111111111111111111111111111111111111
1111111111111110111111111111111111111111111111111111119111111111111111111111111111111111111111111111
1111111111111110111111111111111111111111111111111111119111111111111111111111111111111111111111111111
1111111111111110111111111111111111111111111111111111119111111111111111111111111111111111111111111111
1111111111111000111111111111111111111111111111111111119111111111111111111111111111111111111111111111
1111111111111110111111111111111111111111111111111111119111111111111111111111111111111111111111111111
1111111111111110111111111111111111111111111111111111119111111111111111111111111111111111111111111111
1111111111111101111111111111111111111111111111111111119111111111111111111111111111111111111111111111
1111111111111011111111111111111111111111111111111111119111111111111111111111111111111111111111111111
1111111111111011111111111111111111111111111111111111119111111111111111111111111111111111111111111111
1111111111111011111111111111111111111111111111111111119111111111111111111111111111111111111111111111
1111111111111101111111111111111111111111111111111111119111111111111111111111111111111111111111111111
1111111111111110111111111111111111111111111111111111119111111111111111111111111111111111111111111111
1111111111111111011111111111111111111111111111111111119111111111111111111111111111111111111111111111
1111111111111110011111111111111111111111111111111111119111111111111111111111111111111111111111111111
1111111111111111011111111111111111111111111111111111119111111111111111111111111111111111111111111111
1111111111111111011111111111111111111111111111111111119111111111111111111111111111111111111111111111
1111111111111111011111111111111111111111111111111111119111111111111111111111111111111111111111111111
1111111111000000000000000000000000000000000000000000000000000000000000000111111111111111111111111111
1111111111011111111111111111111111111111111111111111119111111111111111111111111111111111111111111111
1111111111000000000000000000000000000000000000000000000000000000000000000000000000000000000000000111
1111111111111111111111111111111111111111111111111111119111111111111111111111111111111111111111011111
1111111111111111111111111111111111111111111111111111119111111111111111111111111111111111111111011111
1111111111111111111111111111111111111111111111111111119111111111111111111111111111111111111111011111
1111111111111111111111111111111111111111111111100000000000000011111111111111111111111111111111011111
1111111111111111111111111111111111111111111111101111119111111011111111111111111111111111111111011111
1111111111111111111111111111111111111111111111101111117111111011111111111111111111111111111111011111
1111111111111111111111111111111111111111111111101111110111111011111111111111111111111111111111011111
1111111111111111111111111111111111111111111111101111110111111011111111111111111111111111111111011111
1111111111111111111111111111111111111111111111101111110111111011111111111111111111111111111111011111
1111111111111111111111111111111111111111111111101111110000000011111111111111111111111111111111011111
1111111111111111111111111111111111111111111111101111119111111111111111100000000000000001111111011111
1111111111111111111111111111111111111111111111100000000000000000000000000001111111111111111111011111
1111111111111111111111111111111111111111111111111111111111111110111111111111111111111111111111011111
1111111000000000000000000000000000000000000000000000000000000000000000000000111111111111111111011111
1111111111111111111111101111111111111111111111111111111111111111111111111111111111111111111111011111
1111111111111111111111101111111111111111111111111111111111111111111111111111111111100000000000011111
1111111111111111111110000000000000000000000000000000000000000000000000000000000000000000000000001111
1111111111111111111111111111111111111111111111111111111111111111111111111111111111111111111111111111
1111111111111111111111111111111111111111111111111111111111111111111111111111111111111111111111111111